211111111211111111133111111111110
211111111111111113333311111121110
212111111111111111133331112111110
211111111111111121113331111111210
211111111111111111111133111111110
211111100000001111111113111111110
211111000000000011111111311111110
211110003330000011111121111113110
211120003333200000111111111113110
211200003332200001111111111113110
211200000112200001111111111131110
211200000012200001111113111111110
211111111111111111111111133111110
211111111111111111111111111111110
211111111111111111111111133311110
211211111111111111111111111111110
211111111211111111111111111111110
211111111111111111101113333111110
211111111112221111110133333111110
211111111111111111111111111111110
211303331111111111111111111111110
211121111111111111133033311111110
111111113333311113330333311111210
211111111133333333312333111112220
211111111111133333333311111222220
211111112111111333333111112222220
211111111111111113331111112222210
211112111111111111111111111222110
211111111111111111111121111111110
211111111111111111111111111111110
011111111111111111111111111111110
0111111111111111111111111111111110
