111111111111111111111111111111110
111111111111111111111111111111110
111111111111111111111111111111110
111111111111111111111111111111110
111111111111111111111111111111110
111111100000001111111111111111110
111111000000000011111111111111110
111110001110000011111111111111110
111110001111100000111111111111110
111100001111100001111111111111110
111111111111111111111111111111110
111111111111111111111111111111110
111111111111111111111111111111110
111111111111111111111111111111110
111111111111111111111111111111110
111111111111111111111111111111110
111111111111111111111111111111110
111111111111111111111111111111110
111111111111111111111111111111110
111111111111111111111111111111110
111111111111111111111111111111110
111111111111111111111011111111110
111111111111111111110111111111110
111111111111111111111111111111110
111111111111111111111111111111110
111111111111111111111111111111110
111111111111111111111111111111110
111111111111111111111111111111110
111111111111111111111111111111110
111111111111111111111111111111110
011111111111111111111111111111110
011111111111111111111111111111110
